0,0,0,0,0,0,0,1,1,1,0,0,0,0,10,
10,0,9,0,0,0,0,1,1,1,0,0,6,3,3,
3,3,3,3,3,3,3,3,7,0,0,0,2,1,10,
10,0,0,0,0,0,0,0,2,0,0,9,2,1,0,
10,0,0,0,0,0,0,0,2,10,0,9,2,1,0,
3,3,3,3,3,7,0,0,2,0,0,0,2,0,0,
10,8,8,8,0,2,0,0,2,0,0,0,2,0,8,
8,0,8,8,8,2,1,1,2,0,6,3,5,0,0,
8,0,8,8,8,2,1,1,2,0,2,0,0,0,8,
8,8,8,0,8,2,1,1,4,3,5,0,0,0,0,
0,6,3,3,3,5,1,1,1,1,1,1,1,0,0,
0,2,1,1,1,1,1,1,1,1,6,3,3,7,0,
0,2,1,1,1,1,1,1,1,1,2,0,0,2,0,
0,4,3,3,3,3,3,3,3,3,5,0,0,2,0,
0,9,0,0,0,0,0,0,0,0,0,0,10,2,10,
