1,1,1,1,1,1,1,1,1,1,1,1,1,1,1,
1,1,0,0,0,0,9,0,0,0,0,0,0,1,1,
3,3,3,3,3,3,3,3,3,3,3,7,0,0,1,
1,0,0,0,10,0,0,10,0,0,8,2,0,0,1,
1,0,0,0,1,1,1,1,0,0,8,2,0,0,1,
1,0,0,1,1,1,1,1,1,0,8,2,0,9,1,
1,0,1,1,1,8,8,1,1,1,0,2,0,0,1,
1,0,1,1,1,8,8,1,1,1,0,2,0,0,1,
1,0,0,1,1,1,1,1,1,0,8,2,0,0,1,
1,0,9,0,1,1,1,1,0,0,8,2,0,0,1,
1,0,0,0,10,0,0,10,0,0,8,2,0,0,1,
1,0,0,6,3,3,3,3,3,3,3,5,0,0,1,
1,0,0,2,0,0,0,0,0,0,0,0,0,0,1,
1,1,0,2,0,0,0,0,0,0,0,9,0,1,1,
1,1,1,2,1,1,1,1,1,1,1,1,1,1,1,
