1,1,1,1,1,1,1,1,1,1,1,1,1,1,1,
1,1,0,8,0,1,1,1,1,9,0,0,0,0,10,
1,0,8,1,8,0,1,1,1,0,6,3,3,3,3,
1,0,0,8,0,0,1,1,1,0,2,0,0,0,10,
1,1,0,1,1,1,1,1,1,1,2,0,1,1,1,
1,1,1,1,1,1,1,1,1,1,2,0,1,1,1,
1,1,1,1,0,9,0,1,1,0,2,1,1,1,1,
1,1,1,1,6,3,3,3,3,3,5,1,1,1,1,
1,1,1,0,2,0,0,0,0,0,1,1,1,1,1,
1,1,1,0,2,0,1,1,1,1,1,1,0,1,1,
10,0,1,1,2,0,1,1,1,1,0,0,0,1,1,
3,3,3,3,5,0,1,1,0,0,0,0,9,0,1,
10,0,1,1,1,1,1,1,0,0,1,0,0,0,1,
1,1,1,0,9,0,1,1,1,0,1,1,0,1,1,
1,1,1,0,1,1,1,1,1,1,1,1,1,1,1,
