3,3,3,3,3,3,3,3,7,0,0,8,8,0,0,
10,0,0,0,8,8,8,0,4,7,0,8,8,8,0,
10,6,3,7,0,0,8,8,0,2,0,0,0,8,8,
3,5,0,4,3,3,7,0,0,4,3,3,7,0,0,
10,0,8,8,8,0,2,0,8,8,8,0,2,0,0,
0,0,8,0,0,0,2,0,1,1,1,0,2,0,0,
0,8,8,6,3,3,5,8,1,9,1,0,4,7,0,
0,8,8,2,0,0,0,8,1,1,1,8,8,2,0,
0,8,0,2,0,0,0,0,8,8,8,0,8,2,0,
0,8,0,4,3,3,3,3,3,3,3,7,0,2,0,
0,0,8,8,0,0,0,8,0,8,0,2,0,2,0,
10,0,0,0,0,0,0,8,8,8,0,2,0,2,0,
3,3,3,3,3,3,7,0,0,0,0,2,0,2,0,
10,0,0,8,8,0,4,3,3,3,3,5,0,2,0,
0,0,8,8,8,0,0,0,0,0,0,0,10,2,10,
