8,10,8,10,8,10,8,2,8,10,8,10,8,10,8,
10,0,0,0,0,0,0,2,0,0,0,0,0,0,10,
8,0,0,0,0,0,0,2,0,0,0,0,0,0,8,
10,0,0,6,3,3,3,5,0,0,0,0,0,0,10,
8,0,0,2,1,1,1,1,1,1,1,0,0,0,8,
10,0,0,2,1,0,8,8,8,0,1,0,0,0,10,
8,0,0,2,1,8,0,0,0,8,1,0,0,0,8,
10,0,0,2,1,8,0,9,0,8,1,0,0,0,10,
8,0,0,2,1,8,0,0,0,8,1,0,0,0,8,
10,0,0,2,1,0,8,8,8,0,1,0,0,0,10,
8,0,0,2,1,1,1,1,1,1,1,0,0,0,8,
10,0,0,4,3,3,3,7,0,0,0,0,0,0,10,
8,0,0,0,0,0,0,2,0,0,0,0,0,0,8,
10,0,0,0,0,0,0,2,0,0,0,0,0,0,10,
8,10,8,10,8,10,8,2,8,10,8,10,8,10,8,
